11111111111111111111111111111111111111
1000000100010000000000000000C000000001
10000010000000000000000000000000011101
10000000000000000000001000000011111111
100P0000000000JJ0000000000000000011101
10000111110000000000000000000000000001
100100000000000000000JJJ00000000000001
1011000000000010000000000000000J0000J1
1100000000000010000000000000010000J001
1C0000100J000011111111000000000J000001
10001100000001111000000000000J00000001
10010000000000110000000000000000J00J01
10100010000001110000000000000J00000001
1100001000J00111100000000J000000000001
1C0J001000111111110000JJ00000000000E01
11111111111111111111111111111111111111