11111111111111111111111111111111111111
1000000100010000000000000000C000000001
10000010000000000000000000000000011101
10000000000000000000001000000011111111
100P0000000000JJ0000000000000000011101
10000000000000000000000000000000000001
10000000000000000000000000000000000001
1011000000000010000000000000000J0000J1
1100000000000010000000000000010000J001
1C00001000000010000000000000000J000E01
11111111111111111111111111111111111111